W,W,W,W,W,W,W,W,W,9,W,W,W
W,F,F,F,F,F,W,F,F,F,F,F,W
W,F,F,P,F,F,W,W,W,F,F,F,W
W,H,W,F,W,F,W,F,F,V,F,F,W
W,F,F,F,F,H,W,F,K,F,W,W,W
W,F,W,F,W,F,W,F,F,F,F,F,W
W,F,F,F,F,F,W,W,W,W,W,F,W
W,W,W,W,W,F,W,F,F,F,F,F,W
W,F,F,F,F,F,W,F,F,F,F,F,W
W,F,W,F,K,W,W,F,H,F,H,F,W
W,F,W,W,W,W,W,F,F,F,F,F,W
W,F,F,F,F,F,F,F,F,F,F,F,W
W,W,W,W,W,W,W,W,W,W,W,W,W